Version 1 of Fuckbot by XLserpent begins here.
[Version 1 - New Creature]

"Adds a Fuckbot to Flexible Survival's Wandering Monsters table, with impreg chance"

Section 1 - Creature Responses

beatFuckbot is a number that varies.

to say Fuckbot wins:
	if Player is male:
		say "     The cyborg woman wastes no time pushing you down, she has a job to do. She grips your already leaking cock firmly with a silky hand and pauses, as if deciding what to do with you. [if Cock Length of Player < 5]Your little dick is basically drowning in her big hand as she starts to stroke you. You moan from the sensation, feeling yourself already perilously close to the edge when you’ve only just started, and, seeing your state, the fuckbot wastes no time. [otherwise if Cock Length of Player > 13]Your fat, hulking dick throbs menacingly in her grasp as she begins to stroke you. She leans forward, kissing the tip of it to her juicy lips. A long synthetic tongue snakes out of the side, wrapping itself around your big tool as you feel a suction emanate from the inside of her mouth. It’s only around your sensitive tip, but it feels good. She uses both rather large hands on your shaft, working you mechanically as she gives your tip head. It’s tight inside her mouth as even the flexible silicone struggles to accommodate you, so she seems to be set on getting you off with an unsatisfying blowjob.[else]Seemingly liking what she sees, the fuckbot positions herself above you, lining your [cock size desc of Player] cock with her dripping pussy. It feels like warm silk inside her as you slip right in. Her cunt takes you like it was born for your cock and it starts to slowly massage you, the muscles inside squeezing as she begins to move. Wet slapping sounds fill the air as the fuckbot rides you, and you train your eyes on the robotic goddess, taking in the view.[end if]";
		say "     [if Cock Length of Player < 5]Pivoting on a knee, the fuckbot turns, bringing the two of you into a sixty-nine position, and you bite your life as you’re brought face to face with both of her leaking holes. It seems that the giant cyborg was already heating up for some action. Her dripping pussy drools oily synthetic lubricant all over your face, but before you can even frown, she sits her fat ass right on your face. Your cock twitches as you struggle to breathe. She's too heavy to push off so you have no choice but to munch on her twat, hoping the fuckbot will be satisfied with the treatment. It’s an odd site… the fuckbots are usually focused solely on their victim’s pleasure, but as your face turns blue and your dick leaks faster, you realize that this really is turning you on.[otherwise if Cock Length of Player > 13]Synthetic spit covers your parts soon, making the whole process more and more fluid, but you groan, wanting to get deeper in her mouth. Despite the risks of angering the giant android, you can’t help but reach forward and grab her bald head. Without warning, you shove her face down with all your strength, making it slide halfway down your dick. You hear a squelch inside her head as you force yourself deeper in her, and you hold your breath as she reaches a big hand towards your head. Sure that you’re done for, you flinch, but suddenly, sparks fly from behind the fuckbot’s vizor and her lights go out. [else]Her massive tits bounce in your face enticingly, and you can’t help but reach over and give them a squeeze. The cyborg seems to not care, encouraging you. You begin fingering her inverted nipples, making her cunt shake around you. Her pussy seems to water even harder due to your ministrations, creating an oily puddle under you. She rides you, well… like a robot, never breaking pace, and her consistency quickly starts to feel like too much for you. You try to push her off you, not wanting it to end just yet, but the big robot doesn’t even budge.[end if]";
		say "     [if Cock Length of Player < 5]Suddenly, she raises her lips, and you gasp. At the same time, she buries her face in your neglected crotch, swallowing your little prick in one smooth movement. The inside of her mouth shrinks around your dick, massaging it furiously. The stimulation becomes too much for you in an instant. You spasm weakly as you cum in her mouth-pussy, all your sperm disappearing inside her. Her sex-toy mouth doesn’t let up even after you’re drained and oversensitive, trying to get more than the sad amount of seed you provide her, but your dick goes soft. Eventually taking the hint, the fuckbot gets up and starts walking off.[otherwise if Cock Length of Player > 13]With your dick still buried in her mouth, the android powers down. A second later, you hear a jingle, and ‘BOOTUP’ begins to flash on her LED vizor, making you panic. You wonder, for a second, if you should just make a run for it, but the vice-like sensation around your cock lets you know you’re not going anywhere. You begin to fuck her mouth as hard as the tight entrance will allow, attempting to get deeper and deeper. More ominous squelching and creaking fills the air as you force the woman open. Another spark from behind her vizor has you switching gears, not wanting to leave your dick next to potentially hazardous equipment. [else]In fact, your struggle only makes her pick up the pace as she starts riding you harder.  Your balls clench as you try desperately to fight off your orgasm, but her pussy kicks into overgear, massaging you even faster. The fuckbot seems to sense your hesitation, and leans over, pressing her fat tits against your chest and her plump lips against your mouth. As she begins tongue fucking you, you have no choice but to concede. [end if]";
		LineBreak;
		say "     [if Cock Length of Player < 5]'Insemination complete. Thank you for your contribution. Your file has been updated in the database.' you hear as she leaves. It’s in the exact same tone as before, but you can’t help but feel as though there’s some derision in her statement.[otherwise if Cock Length of Player > 13]Her head falls to the asphalt as you walk behind her. Lining up your dong, you waste no time pushing in as hard as you can. Her stomach bulges underneath her as you get to work opening her up. WIthout any foreplay, it’s nearly as tight as the mouth, but you don’t really care as long as you don’t get burnt. Bit by bit, she starts to take your length to the hilt. A reboot sound coming from her body lets you know that you’re running out of time. You slam into her like you’ve gone mad, making her exterior creak from the pressure. Balls slap again and again against her roboclit as you try to cum, but it’s still uncomfortably tight inside her. The fuckbot raises its head and turns towards you, vizor fully functional again and you can only desperately fuck her as she reaches for you again. Suddenly, the hand moving towards you clenches into a fist, and you feel the robot’s body begin to shake furiously. You thank god for the malfunction as her insides oscillate against your shaft in the telltale signs of an orgasm. [else]Your eyes roll back into your head as you start to cum, and the cyborg plants her cunt right against your pelvis for the last time. However, despite her body being still on the outside, her vagina squeezes and milks you, moving independently of the robot’s outer form. It seems to go on endlessly, as she tries to relieve you of every last drop of cum.[end if]";
		say "     [if Cock Length of Player > 13]The fuckbot’s ‘malfunction’ is just what you need, and you slam yourself into her one last time. Her stomach distends even further as she absorbs the sheer quantity of your seed. Despite her haggard form, her insides squeeze and milk you like a pro. Your balls are completely empty when you walk away. Her twitching, malfunctioning body makes you wonder who really won that exchange. [else]Eventually, she gets off you and smiles. 'Insemination complete. Thank you for your contribution. Your file has been updated in the database.' is the last thing you hear before she walks away. [end if]";
		CreatureSexAftermath "Fuckbot" receives "PussyFuck" from "Player";
	else:
		if Player is female:
			say "     One quick look between your legs lets the fuckbot know that you don’t have the parts she’s looking for. Wasting no more time, she turns around and walks away, leaving you on your own.";
		else:
		    	say "     One quick look between your legs lets the fuckbot know that you don’t have the parts she’s looking for. Wasting no more time, she turns around and walks away, leaving you on your own.";


to say Fuckbot loses:
	say "     The android collapses backwards, sprawling across the concrete. A strange jingle emanates from behind her visor as she seems to reboot, and after a moment she raises her head once again, looking directly at you from between the crevice of her massive chest. Feeling as though the fight may not be over, you tense. In response, the Fuckbot spreads her legs with a serene smile, giving you a good view of a perfect hot-pink pussy. ";
	LineBreak;
	say "     'Would you like to donate to the cause?'";
	if Player consents:
		say "[FuckbotSexSelection]";
	else:
		say "     You don’t know what kind of cause needs your cum, but you're not feeling particularly charitable. You take one last look at the seductive robot before turning and heading on your way."


to say FuckbotSexSelection:
	LineBreak;
	now sextablerun is 0;
	blank out the whole of table of fucking options;
	[]
	if Player is male:
		choose a blank row in table of fucking options;
		now title entry is "Give me that pussy";
		now sortorder entry is 1;
		now description entry is "Give her what she wants";
	[]
	if Player is male:
		choose a blank row in table of fucking options;
		now title entry is "Suck me off";
		now sortorder entry is 2;
		now description entry is "Put those big lips to use";
	[]
	if Player is male:
		choose a blank row in table of fucking options;
		now title entry is "See if she’s got another hole";
		now sortorder entry is 3;
		now description entry is "Have some anal fun";
    []
	if Player is not male:
		choose a blank row in table of fucking options;
		now title entry is "Make her get on her knees and service you";
		now sortorder entry is 4;
		now description entry is "Put the fuckbot's tongue to use";
	[]
	sort the table of fucking options in sortorder order;
	repeat with y running from 1 to number of filled rows in table of fucking options:
		choose row y from the table of fucking options;
		say "[link][y] - [title entry][as][y][end link][line break]";
	say "[link]0 - Nevermind[as]0[end link][line break]";
	while sextablerun is 0:
		say "Pick the corresponding number> [run paragraph on]";
		get a number;
		if calcnumber > 0 and calcnumber <= the number of filled rows in table of fucking options:
			now current menu selection is calcnumber;
			choose row calcnumber in table of fucking options;
			say "[title entry]: [description entry]?";
			if Player consents:
				let nam be title entry;
				now sextablerun is 1;
				if (nam is "Give me that pussy"):
					say "[FuckbotFuck1]";
				if (nam is "Suck me off"):
					say "[FuckbotFuck2]";
				if (nam is "See if she’s got another hole"):
					say "[FuckbotFuck3]";
				if (nam is "Make her get on her knees and service you"):
					say "[FuckbotFuck4]";
			wait for any key;
		else if calcnumber is 0:
			now sextablerun is 1;
			say "     You step away from the android, shaking your head slightly as she watches.";
			wait for any key;
		else:
			say "Invalid Option. Pick between 1 and [the number of filled rows in the table of fucking options].";
	clear the screen and hyperlink list;

to say FuckbotFuck1:
	say "     The fuckbot’s slit begins to drool as you stare, getting wet on command. She smiles as she reaches down and pulls her pussy lips apart, giving you a good view of her slick, wet channel. You swallow involuntarily. Slowly, you move towards the big android woman, your hard [cock size desc of Player] cock bouncing with each step. You can’t see her eyes behind the vizor, or even know if she has eyes, but you can feel her sights locked onto your [if Cock Length of Player > 13]huge, hulking dick. Your fat nuts sway enticingly underneath, and you know her real target is what’s inside.[otherwise if Cock Length of Player < 5]little prick. It was nothing amazing, but the fuckbot acted plenty interested, regardless. [else]member. You know she wants nothing more than to milk you… This is what they live for.[end if]";
    say "     You brush your tip against her snatch, teasing it. Slowly, you dip your head in before pulling it out. Over and over, you tease her, and her cunt is completely soaked with slick synthetic lubricant when you’re done. She’s leaking like a faucet, creating an oily puddle on the ground below you. You bite your lip as her entrance begins to create suction, trying to use her vaginal muscles to coax you further inside her. Before you’re able to give her what she wants, the android takes it.";
	say "     Placing her hands on your hips, the large woman shoves you in, herself, burying the full length of your [cock size desc of Player] cock inside her. [if Cock Length of Player > 13]You groan as her channel squeezes around your fat cock in a vice grip. She adjusts quickly, her silicone walls shrinking back to adjust to your girth. Smugly, you realize that you’re a little larger than what she’s used to getting around here. The hands on your hips are still as she calibrates her canal, but you don’t think you feel like waiting. [otherwise if Cock Length of Player < 5]Your prick slips in easily, and the fuckbot is completely unfazed by your intrusion. She hardly misses a beat as her hands begin to move you in and out of her. Wet slaps fill the air as she moves you like a dildo, fucking herself on your dick like she owns it. More fluid gushes out as you are slammed into her nonstop, pouring out from around your cock. The fuckbot tries to make herself tighter, and she succeeds to a certain degree, but it’s still quite roomy in her pussy, and your [cock size desc of Player] penis just isn’t enough to fill it. Still, her wet snatch feels incredible. [else]It’s a perfect fit, squeezing your member just right. The two of you still for a moment, just savoring the feeling of her walls massaging your member. She pulls you out of her gently, and it's the only signal you need to get to work.[end if]";
    WaitLineBreak;
	say "     [if Cock Length of Player > 13]You begin slamming into the fuckbot, hard. Her still-too-tight pussy spasms around you in response, squirting slightly as you dig deep inside her. The lubrication only makes it easier for you and you start fucking her even faster. Her walls stretch to their full capacity, but it’s still pretty snug inside her, and her pussy desperately clings to your cock as you pull out. You grin. You’re about to turn this slut inside out. In missionary, you’re face to face with the fuckbot’s tits, and they bounce enticingly in your face. You reach down and squeeze. The soft flesh sinks under your hands like water balloons as you play with them. You bend over without stopping your hips, taking a heart-shaped inverted nipple in your mouth. It tastes artificially sweet… like flavored lube, but you don’t care. You begin to practically make out with the nipple, trying to dig it out with your tongue.[otherwise if Cock Length of Player < 5]It feels like a slip and slide inside her as she continues to move your hips for you. Feeling slightly emasculated, you try to wrestle back some of the control. You push her hands away and start thrusting on your own. You jackhammer her pussy like you have something to prove, but the robot shows no reaction to your harsh treatment. No matter how hard you fuck, it’s useless. You realize that you simply don’t have the right equipment. Discouraged, you slow to a stop, panting hard from exertion.[else]Starting with slow, deep strokes, you savor the robot woman’s warm, silky interior. The fuckbot lays on her back as she takes you, but her pussy is hard at work. Her hole grips you in all the right places, massaging your cock like an advanced sex toy. The suction feels incredible, and you already feel yourself getting closer.[end if]";
	say "     [if Cock Length of Player > 13]Her pussy begins to heat up around your cock more and more as you fuck, and it feels good. The android is like a fountain of lube, and her insides are starting to feel like a sauna. Your heavy balls slap her asshole as you get closer and closer. The nipples begin to frustrate you as you realize you’re unable to suck them out. You dig your fingers inside, making the fuckbot begin shuddering beneath you, but despite your best attempts, you are unable to revert the nipples.[otherwise if Cock Length of Player < 5]The fuckbot, however, does not plan on taking any breaks. Noticing your downtrodden state, she sweeps you off your feet, literally. The android grabs you under your knees, lifting you as she stands up. Your little prick slips out with all the movement, but she quickly pushes it back in and starts to rock you back and forth. You moan as the robot fucks you back. She sets a brutal pace, and you know you’re getting close.[else]You slow to a stop, not wanting this experience to be over already, and the android grabs your hips impatiently, but before she can move you, you take her arms and pin her down. She remains expressionless but you feel her pussy twitch and heat up in response. You smirk at her. It's your turn to set the pace.[end if]";
	say "     [if Cock Length of Player > 13]You dig your other hand into her remaining breast, fingering both inverted nipples, using them to leverage yourself as you continue to fuck the big robot. The fuckbot says nothing, but her body shakes even harder. Knowing you’re in the home stretch, you pull her into a mating press. You set a pace far more brutal than before, using her tits as handles as your fuck her. Face to face with the bot, you can’t help but stare at her juicy lips. To your surprise, she starts to speak, ‘Warning! System overload. Please dismount and wait f-’[else if Cock Length of Player < 5]She doesn’t let you go, continuing to pull all the weight as she uses your dick. You no longer fight it, reduced only to a little cock for the big bimbo robot to milk. Even when you start to cum, the fuckbot doesn’t let up, grinding your cock inside her. The pressure on your pelvis lets you know that she’s trying to get you deeper inside her, so you can properly inseminate her, but you’re all out of dick.[else]Hips still as before, you maneuver the fuckbot’s legs above her head. Her ass is so fat that you can basically use it as a cushion, and you just sit on her, making sure that your cock is buried to the hilt. You then bend forward and start sucking on her massive tits. Her inverted nipples seem to be stuck inside no matter how much you suck and fondle them, but the robot’s pussy twitches as you play with them. Slowly you feel her relax under you. Despite her lack of expression and speech, you feel like she's enjoying herself. [end if]";
	WaitLineBreak;
	say "     [if Cock Length of Player > 13]The announcement continues even as you stick your tongue down her throat, but you’re too lost in the heat of passion to hear it anymore. You’re like a piston on top of her, fucking her in a frenzy. You hardly even notice when she begins convulsing violently, but then her pussy squeezes tighter than ever before, and you start to pump her full of your babies.[otherwise if Cock Length of Player < 5]When the last bit of cum leaves your body, the android drops you. You land on your face, not expecting the sudden disregard towards you, but before you can complain, she turns around and begins to walk away.[else]You don’t move but her twitching vagina massages your cock like a pro, stroking it from the inside, and despite all your efforts, you know that you are about to cum. Tenderly, you caress the fuckbot’s face, kissing her as you begin to move again. With your hands in her tits, your tongue down her throat, and your dick fucking her wet twat, her insides twitch more and more. Slamming into her harder with every thrust, you feel your balls contract in preparation. Suddenly, you feel your tip poke something.[end if]";
	say "     [if Cock Length of Player > 13]The orgasm feels like it lasts forever and the fuckbot pulls your body close, wrapping her legs around you to ensure you won’t waste any of your seed. After a few minutes, your balls are completely drained and you pull away from her lazily, exhausted from the workout you just experienced. You wince as you pull your oversensitive cock out of her tight hole. The android seems to be in worse shape, though, and she lays on the ground steaming and twitching. [otherwise if Cock Length of Player < 5]'Insemination complete. Thank you for your contribution. Your file has been updated in the database.' you hear as she walks away [else]A fuckbot’s insides are usually malleable, like a more solid slime, so you know that there is only one thing you could be hitting. You’re kissing her womb, the most protected part of her body. It’s more than enough to push you over the edge, and you push your dick as deep as it can go, cumming directly into the entrance of her babymaker. Her snatch shudders violently as she accepts your seed, making you groan in pleasure. Her vizor flickers as hearts fill the LED screen.[end if]";
	WaitLineBreak;
	say "     [if Cock Length of Player > 13]’Insemination complete. Thank you for your contribution. Your file has been updated in the database.' she says. 'Contributor has been marked as VIP.'[otherwise if Cock Length of Player < 5]Something tells you that she wasn’t impressed by your performance.[else]'Insemination complete. Thank you very much for your contribution. Your file has been updated in the database.' she says. 'Contributor has been marked as VIP.' You smile and give her one last kiss before you go your separate ways.[end if]";
	CreatureSexAftermath "Fuckbot" receives "PussyFuck" from "Player";

to say FuckbotFuck2:
	say "     Your dick throbs as you gaze at the fuckbot’s face. The big, red silicone lips are clearly made to resemble red lipstick, and despite their inorganic makeup, they look soft and plush. As if feeling your gaze, the android slowly opens its mouth, revealing a long, drooling tongue. In fact, the inside of the mouth looked very well lubricated, oozing a synthetic saliva, and seeming incredibly inviting.";
    say "     You approach the creature with your cock in hand and stand over her when her hands reach up toward you and pull you down. You go along with it, sitting on her prodigious breasts. Her huge tits are soft under you, cushioning you like a beanbag as you scott closer to her face, lining your tip up to her lips.";
    say "     Sticking the tip in, she immediately begins to suck on it like a vacuum, making you groan. Pushing your [cock size desc of Player] dick deeper, [if Cock Length of Player > 13]it feels like a vice grip around you. But, somehow, her insides seem to adjust, the silicone spreading pleasantly around your big dick to the best of its ability. Slowly, you begin to work her open.[otherwise if Cock Length of Player < 5]it feels embarrassingly spacious inside her mouth, but you moan as you feel the silicone inflate around you, molding into the perfect cocksleeve for your member. She clearly doesn’t discriminate but something tells you she’s used to milking bigger cocks in this city.[else]you moan. Your dick slides in smoothly, clinging you in all the right places.[end if]";
    say "     Once you’re buried to the hilt, you pause, but the robot seems to have other hands. It doesn’t even skip a beat as it begins bobbing its head smoothly up and down your shaft. She starts at a slower pace, but begins to ramp up as lean back on her boobs, placing your hands behind your head and letting her do her thing. The blowjob is sloppy, with synthetic drool dripping off your balls every time she kisses your pelvis. Her movements are perfect, and you feel yourself getting closer, fast. As if sensing it, the fuckbot begins to go even faster.";
    say "     Something tells you she doesn’t mind if you’re a quick nut, so you finally get to work yourself. Holding her head in place, you begin to fuck her face, hard. Your balls slap her chin so loud, you’re worried you’re gonna draw a crowd, but it only makes you go harder. The fuckbot can no longer move, but the inside of her mouth gets tighter, massaging you in perfect sync as you fuck her. The suction power only mounts as you bury your bone inside her one last time.";
    say "     There are no plans of pulling out from your end but arms wrap around your hips, regardless, holding you in place. You cum buckets down her throat, and she doesn’t let you pull out until she’s licked off every last drop. When she finally lets you go, your [cock size desc of Player] cock is dripping with the synthetic drool. The same substance covers her face and torso as she smiles at you. Her visor blinks as two heart symbols flash where her eyes would be.";
    WaitLineBreak;
    say "     'Insemination complete. Thank you for your contribution. Your file has been updated in the database.'";
	CreatureSexAftermath "Fuckbot" receives "PussyFuck" from "Player";

to say FuckbotFuck3:
	say "     The fuckbot spreads her legs more as you move closer, and her pussy seems to drool in anticipation, but you have other plans. In one quick movement, you flip her over. The android lands on her huge boobs and they spill out of the sides of her body from underneath her. The big woman is heavy, and manhandling her isn’t easy but, spreading her fat ass, you find your goal.";
	say "     Her pucker is the same color as her pussy, a brighter pink than the rest of her body, and your [cock size desc of Player] cock throbs as it winks at you invitingly. A glob of pre rolls off the head, landing right on her hole. It’s all the lube she’s getting from you. You line up your dick and shove it in recklessly[if Cock Length of Player < 5] and it just slips right in there. Your rather diminutive cock poses no challenge to the fuckbot, it seems, but once you’re buried in her, her hole seems to tighten up around. The silicone in her ass inflates until she is hugging you almost perfectly, and you can’t wait any longer. This is clearly her tightest hole.[else]. There’s an ecstatic friction as you drive deep within her, letting you know that this side of her definitely hasn’t been getting as much action. The bot is after sperm after all. Well, she’s gonna get her sperm, but you’ll be deciding where it goes.[end if]";
	say "     You hammer in and out of her, hard and fast, as a slimy substance begins to cover your cock. It seems as though the robot is capable of lubricating any of her orifices. It’s not particularly surprising to you since she’s just a mechanical slut made for fucking. Her huge ass jiggles as you nail her from the back and you can’t help but slap it. The silicon reacts to your abuse, surprisingly, and her baby pink skin blushes red.";
	say "     The fuckbot makes no noise as you slam into her as hard as you can, but her hole heats up comfortably and her insides begin to pulse, squeezing your cock just as you bury it as deep as you’re able. 'Warmup complete.' she says, shocking you. This bitch isn’t even taking you seriously. Insulted by her lack of response, you redouble your efforts, leaning your entire weight on the massive woman as you go full pronebone.";
	say "     [if Cock Length of Player > 13]Something finally shifts, and to your surprise, the fuckbot begins to shake. Your massive dong seems to be doing something! She turns her head back towards you to face you, a completely serene expression covering her face, and says, ‘Warning! System overload. Please dismount and wait for the anal cavity to cool down.’ As if you’re gonna listen to her. You ignore her and continue your assault. Her body continues to shudder, almost vibrating underneath you as her ass starts to feel like a hot tub. [else]But despite all your efforts, nothing seems to phase the fuckbot. She's seen bigger and better in this city, no doubt. You grit your teeth and try anyway, but it isn’t long till you’re no longer able to hold on. As if reading your thoughts, the giant woman makes her move. Caught off guard, you’re unable to stop her as she pushes you backwards. Your cock never even leaves her ass as you suddenly find yourself on your back with the huge woman riding you reverse cowgirl. Your efforts to dominate her has failed, and now it’s her turn her fucking YOU.[end if]";
	say "     [if Cock Length of Player > 13]‘Please dismount and wait for the anal cavity to cool down.’ she repeats, practically spasming now. ‘Critical heat levels are being surpassed. Dismount immediately. Dismount immediately. Dismount immedi-’ The lights behind her visor seem to flicker as the audio cuts off, and two hearts start to flash where her eyes should. As she loses control, her long tongue slips out of her and she begins to drool furiously. Her back arches, and her ass constricts, gripping you so tight that it’s almost painful. The silicon around your fat dick convulses violently, and you’re pushed over the edge. Even while malfunctioning, the fuckbot milks you like a pro.[else]With no way to even struggle under her weight, you watch as she rides you hard and fast. Her warm insides squeeze as you shudder. Your eyes roll back as you feel yourself cum hard inside her. Feeling that her task is nearly complete, the fuckbot slows down, but doesn’t pull off until she’s milked every last drop from your balls.[end if]";
	WaitLineBreak;
	say "     [if Cock Length of Player > 13]Slowly, she starts to calm down, and you fuck her through her… orgasm? Your dick is sticky when you pull it out. Looks like the lube doesn’t mesh well with that kind of heat. Surprisingly, none of the copious amounts of cum you deposited in her seems to spill out. She stands up and turns around, sporting a literal baby bump from all the fluid inside her.[else]'Insemination complete. Thank you for your contribution. Your file has been updated in the database.' she says before walking off without looking back.[end if]";
	WaitLineBreak;
	say "     [if Cock Length of Player > 13]'Insemination complete. Thank you for your contribution. Your file has been updated in the database.' she says, cradling her stomach. 'Contributor has been marked as VIP.' What that means, you have no idea.";
	CreatureSexAftermath "Fuckbot" receives "PussyFuck" from "Player";

to say FuckbotFuck4:
	say "     [if Cunt Depth of Player > 0]You know you don’t have the parts that the fuckbot wants, but you’re the one who won so it hardly matters. Pulling the fuckbot up to her knees, you bring her face to face with a new type of anatomy. Your pussy is already wet in anticipation and for her part, the robot’s stoic face betrays no emotion as she gets to work on your cunt.[else]You know you don’t have the parts that the fuckbot wants, but you’re the one who won so it hardly matters. Pulling the fuckbot up to her knees, you bring her face to face with a different type of anatomy. Your ass clenches in anticipation and for her part, the robot’s stoic face betrays no emotion as she gets to work on your hole.[end if]";
	say "     [if Cunt Depth of Player > 0]The fuckbot’s tongue is long and fast, and you struggle to stay standing as she eats you out. She swipes it back and forth, covering your slit in her synthetic drool, before really homing in on your clit. Those big red lips part in a small ‘O’ and you begin to feel suction right on your button. Your legs shake violently under her relentless assault as you begin to cum. [else]The fuckbot’s tongue is long and fast, and you struggle to stay standing as she eats you out. She swipes it back and forth, covering your ass in her synthetic drool. Your legs shake violently under her relentless assault as you begin to cum without a crotch.[end if]";
	say "     [if Cunt Depth of Player > 0]Over and over, she gets you off, and when you’re finally satiated, you let her go. The fuckbot leaves without a word, seemingly having no voice lines for the situation, but you just smile, grateful that she was at least programmed to eat pussy. [else]Over and over, she gets you off, and when you’re finally satiated, you let her go. The fuckbot leaves without a word, seemingly having no voice lines for the situation, but you just smile, grateful that she was at least programmed to eat ass.[end if]";

to say FuckbotDesc:
	say "     Before you stands a towering woman made entirely of synthetic material. She’s nearly 7 feet tall sporting a curvy hourglass body and massive tits with large, heart-shaped nipples. Despite her clear robotic nature, she looks soft. Her plush, baby pink skin makes no effort to look like anything other than silicone, but combined with her bimbo proportions, you feel your body involuntarily heat up.";
	say "     Where her eyes should be is a built-in visor, but her big, red, blowjob lips were proudly on display, and as she sets her sights on you, they twist into a placid smile. 'Target acquired. Commencing incubation protocol.' you hear a mechanical voice emanate from her, but her lips don’t move.";

Table of CombatPrep (continued)
name(text)	PrepFunction(text)
"Fuckbot"	"[PrepCombat_Fuckbot]"

Table of Random Critters (continued)
NewTypeInfection (truth state)	Species Name	Name	Enemy Title	Enemy Name	Enemy Type	Attack	Defeated	Victory	Desc	Face	Body	Skin	Tail	Cock	Face Change	Body Change	Skin Change	Ass Change	Cock Change	str	dex	sta	per	int	cha	sex	HP	lev	wdam	area	Cock Count	Cock Length	Ball Size	Nipple Count	Breast Size	Male Breast Size	Cunt Count	Cunt Depth	Cunt Tightness	SeductionImmune	Libido	Loot	Lootchance	TrophyFunction	MilkItem	CumItem	Scale (number)	Body Descriptor (text)	Type (text)	Magic (truth state)	Resbypass (truth state)	non-infectious (truth state)	Cross-Infection (text)	DayCycle	Altcombat (text)	BannedStatus (truth state)
--	--	--	--	--	--	--	--	--	--	--	--	--	--	--	--	--	--	--	--	--	--	--	--	--	--	--	--	--	--	--	--	--	--	--	--	--	--	--	--	--	--	--	--	--	--	--	--	--	--	--	--	--	--	--	--	--;

When Play begins:
	Choose a blank row from Table of Random Critters;
	now NewTypeInfection entry is false;
	now Species Name entry is "Fuckborg";
	add "Fuckbot" to infections of NonOrganicList;
	add "Fuckbot" to infections of FemaleList;
	add "Fuckbot" to infections of BipedalList;
	add "Fuckbot" to infections of NotBreathingList;
	now Name entry is "Fuckbot";
	now enemy title entry is ""; [ Name of the encountered creature at combat start - Example: "You run into a giant collie." instead of using "Smooth Collie Shemale" infection name. ]
	now enemy Name entry is ""; [ Specific name of unique enemy. ]
	now enemy type entry is 0; [ 0 = non unique enemy; 1 = unique (unknown name); 2 = unique (known name) | Used to disqualify unique enemies from Vore/UB and showing the enemy name in encounters. ]
	now attack entry is "[one of]She jumps on you, trying to smother you under her huge breasts.[or]She pulls you in for a deep kiss and for a second you consider just giving in.[or]The Fuckbot turns around and shakes her fat ass. You watch transfixed as her cheeks part, her drooling holes enticing you.[at random]";
	now defeated entry is "[Fuckbot loses]";
	now victory entry is "[Fuckbot wins]";
	now desc entry is "[FuckbotDesc]";
	now face entry is "masculine but soft, appealing to a wide variety of consumers. An LED visor occupies the space where your eyes should be paired with plump lips.";
	now body entry is "the size of a rather tall human with rippling muscles that look soft and plush no matter how much you flex. Your puffy nipples are in the shape of a heart and sit enticingly on your wide, barrel chest.";
	now skin entry is "smooth, baby blue, silicone"; [ format as "Your body is covered in (your text) skin"]
	now tail entry is ""; [ write a whole Sentence or leave blank. ]
	now cock entry is "baby-blue"; [ format as "You have a 'size' (your text) cock ]
	now face change entry is "it shapes itself into a chiseled male profile, appearing nearly robotic. A hightech LED vizor appears out of nowhere, locking itself onto your face"; [ format as "Your face feels funny as (your text)." ]
	now body change entry is "it is reshaped into a towering, muscled male form and your pecs fill up like balloons. They sit nicely with new heart-shaped nipples above your washboard abs"; [ format as "Your body feels funny as (your text)." ]
	now skin change entry is "it takes on a light blue hue and smoothens out completely. A quick touch informs you that you are now comprised of silicone"; [ format as "Your skin feels funny as (your text)." ]
	now ass change entry is "it changes into a nice, fat bubble butt. Your insides shift as well, making you moan as a little synthetic lubricant spills out of your hole"; [ format as "Your ass feels funny as (your text)." ]
	now cock change entry is "it changes into silicone. A quick squeeze reassures you that it is still fully in working order"; [ format as "Your cock feels funny as (your text)." ]
	now str entry is 14;
	now dex entry is 12;
	now sta entry is 18;
	now per entry is 14;
	now int entry is 11;
	now cha entry is 18;
	now sex entry is "Male";
	now HP entry is 72;
	now lev entry is 8;
	now wdam entry is 11;
	now area entry is "High"; [ Case sensitive]
	now Cock Count entry is 1; [ number of cocks if sex is 'Male' or 'Both' ]
	now Cock Length entry is 10;
	now Ball Size entry is 5; [ Size of balls ]
	now Nipple Count entry is 2; [ Number of nipples. ]
	now Breast Size entry is 0; [cup size as number, counting Flat Pecs = 0, A = 1, B = 2, ...]
	now Male Breast Size entry is 0; [ Breast size for if Sex="Male", usually zero. ]
	now Cunt Count entry is 0; [ number of pussies if sex is 'Female' or 'Both' ]
	now Cunt Depth entry is 0;
	now Cunt Tightness entry is 3; [size 1-5, generates adjectives of extremely tight/tight/receptive/open/gaping]
	now SeductionImmune entry is false;
	now libido entry is 80; [ As part of infection, the Player will be gradually moved towards this value; also used for the creature's seduce defense as a penalty ]
	now loot entry is "Fuckborg CD"; [ Dropped item, blank for none. Case sensitive. ]
	now lootchance entry is 30; [ Percentage chance of dropping loot, from 0-100. ]
	now MilkItem entry is ""; [ Item to be given to the player if they have this infection and milk themselves. ]
	now CumItem entry is ""; [ Item to be given to the player if they have this infection and jerk off. ]
	now TrophyFunction entry is "-"; [ Function to generate a list of optional loot items, of which the player can choose one after victory. ]
	now scale entry is 3; [ Number 1-5, approx size/height of infected PC body: 1=tiny, 3=avg, 5=huge ]
	now body descriptor entry is "[one of]muscled[or]hunky[or]strong[at random]"; [ Ex: "plump" "fat" "muscled" "strong" "slimy" "gelatinous" "slender". Use [one of] to vary ]
	now type entry is "robotic"; [ one-word creature type. Ex: feline, canine, lupine, robotic, human... Use [one of] to vary ]
	now magic entry is false;
	now resbypass entry is false;
	now non-infectious entry is false;
	now Cross-Infection entry is ""; [ Infection that this infection will give the player when they lose; can be left empty if they infect with the monster's own strain. ]
	now DayCycle entry is 0; [ 0 = Up at all times; 1 = Nocturnal (night encounters only); 2 = Diurnal (day encounters only) ]
	now altcombat entry is "default";
	now BannedStatus entry is false;

[
Table of New Infection Parts (continued)
Species Name	Name	Body Weight	Body Definition	Androginity	Head Change	Head Description	Head Adjective	Head Skin Adjective	Head Color	Head Adornments	Hair Length	Hair Shape	Hair Color	Hair Style	Beard Style	Body Hair Length	Eye Color	Eye Adjective	Mouth Length	Mouth Circumference	Tongue Adjective	Tongue Color	Tongue Length	Torso Change	Torso Description	Torso Adjective	Torso Skin Adjective	Torso Adornments	Torso Color	Torso Pattern	Breast Adjective	Breast Size	Male Breast Size	Nipple Count	Nipple Color	Nipple Shape	Back Change	Back Adornments	Back Skin Adjective	Back Color	Arms Change	Arms Description	Arms Skin Adjective	Arms Color	Locomotion	Legs Change	Legs Description	Legs Skin Adjective	Legs Color	Ass Change	Ass Description	Ass Skin Adjective	Ass Color	Ass Width	Tail Change	Tail Description	tail skin adjective	Tail Color	Asshole Depth	Asshole Tightness	Asshole Color	Cock Change	Cock Description	Cock Adjective	Cock Color	Cock Count	Cock Girth	Cock Length	Ball Description	Ball Count	Ball Size	Cunt Change	Cunt Description	Cunt Adjective	Cunt Color	Cunt Count	Cunt Depth	Cunt Tightness	Clit Size
--	--	--	--	--	--	--	--	--	--	--	--	--	--	--	--	--	--	--	--	--	--	--	--	--	--	--	--	--	--	--	--	--	--	--	--	--	--	--	--	--	--	--	--	--	--	--	--	--	--	--	--	--	--	--	--	--	--	--	--	--	--	--	--	--	--	--	--	--	--	--	--	--	--	--	--	--	--	--	--;

When Play begins:
	Choose a blank row from Table of New Infection Parts;
	now Species Name entry is ""; [ Name of the overall species of the infection, used so a "male x" and "female x" have "pureblood X" children. ]
	now Name entry is ""; [matching infection name to Table of Random Critters]
	now Body Weight entry is 6; [scale of 1-9 for body weight, grouped into low weight (1-3), mid weight (4-6) and high weight (7-9)]
	now Body Definition entry is 5; [scale of 1-9 for body definition, grouped into low muscle (1-3), mid muscle (4-6), high muscle (7-9)]
	[Body Adjective is generated out of the body weight and body definition and can be used in scenes - one word descriptive adjective depending on weight and definition groups: low weight group: skinny/slender/lithe; mid weight group: average/fit/muscled; high weight group: pudgy/husky/jacked]
	now Androginity entry is 5; [1-9 scale of hypermasculine to hyperfeminine]
	[Gender Adjective is generated out of androginity 1-9: hypermasculine/masculine/effeminate/somewhat effeminate/androgynous/feminine butch/tomboyish/feminine/hyperfeminine]
	now Head Change entry is ""; [partial sentence that fits in: "Your head and face [one of]tingle[or]go flush[or]vibrate with odd pleasure[or]go cold[or]feel oily[at random] as [head change entry]."]
	now Head Description entry is ""; [partial sentence that fits in "Your face and head resemble that of [Head Description of Player]. You have [Eye Adjective of Player], [Eye Color of Player] eyes and an overall [Gender Adjective of Player] appearance."]
	now Head Adjective entry is ""; [one word descriptive adjective (avian/canine/...)]
	now Head Skin Adjective entry is ""; [one word descriptive adjective]
	now Head Color entry is ""; [single word color adjective for the dominant color of the skin/fur/feathers/scales]
	now Head Adornments entry is "";[partial sentence that fits in "Before moving on from your head, you give your [Head Adornments of Player] a proud glance followed by a light caress."]
	now Hair Length entry is 2; [hair length in inches]
	now Hair Shape entry is ""; [one word shape descriptor (curly/straight/...)]
	now Hair Color entry is ""; [one word color descriptor]
	now Hair Style entry is ""; [one word style descriptor (ponytail/mohawk/buzzcut/...) to fit "On top of your head you have [Hair Length of Player] inch long, [Hair Shape of Player] [Hair Color of Player] hair in the [Hair Style of Player] style."]
	now Beard Style entry is ""; [short beard style (goatee/3-day stubble beard/porn stache/mutton chops beard/...) to go into "You have a [Hair Color of Player] [Beard Style of Player]."]
	now Body Hair Length entry is 0; [numerical value, 0-4 (no body hair/light/moderate/heavy/furry) - only set to > 0 if the infection does not have fur/scales/etc. !]
	now Eye Color entry is ""; [one word color descriptor]
	now Eye Adjective entry is ""; [one word descriptive adjective (slitted/round/...)]
	now Mouth Length entry is 3; [inches deep for face fucking; maximum possible will be double this number (when deep throating)]
	[Mouth Length Adjective is generated by a function and can be used in scenes too - "petite, shallow, average, deep, bottomless"]
	now Mouth Circumference entry is 3; [mouth circumference 1-5, see Mouth Circumference Adjective]
	[Mouth Circumference Adjective is generated by a function and can be used in scenes too - "tiny, small, normal, wide, gaping"]
	now Tongue Adjective entry is ""; [one word descriptive adjective (wide/slobbery/...)]
	now Tongue Color entry is ""; [one word color descriptor]
	now Tongue Length entry is 3; [length in inches]
	now Torso Change entry is ""; [partial sentence that fits in: "Your torso [one of]tingles[or]goes flush[or]vibrates with odd pleasure[or]goes cold[or]feels oily[at random] as [Torso Change entry]."]
	now Torso Description entry is ""; [partial sentence, fitting in "Looking down at yourself, you appear [Gender Adjective of Player] with a [Body Adjective of Player] build. Your torso is [Torso Description of Player][if Body Hair Length of Player > 1], covered in [Torso Color of Player] skin and [Body Hair Description of Player][else if Body Hair Length of Player is 1], covered in smooth, [Torso Color of Player] skin[end if]."]
	now Torso Adjective entry is ""; [one word descriptive adjective (avian/canine/...)]
	now Torso Adornments entry is ""; [(pouch/udders/...); partial sentence to fit: "You take a moment to feel your [Torso Adornments of Player]."]
	now Torso Skin Adjective entry is ""; [one word adjective (feathered/furred/scaly/...); EMPTY "" for creatures with just skin]
	now Torso Color entry is ""; [single word color adjective for the dominant color of the skin/fur/feathers/scales]
	now Torso Pattern entry is ""; [single word color adjective for the dominant pattern of the skin/fur/feathers/scales]
	now Breast Adjective entry is ""; [adjective(s) example: round, pointy, perky, saggy, bouncy. This would serve as either a general appearance of a infections breasts or possibly something that may be effected by a item or NPC.]
	now Breast Size entry is 0; [cup size as number, counting Flat Pecs = 0, A = 1, B = 2, ...]
	now Male Breast Size entry is 0; [cup size as number, counting Flat Pecs = 0, A = 1, B = 2, ...]
	now Nipple Count entry is 2; [count of nipples]
	now Nipple Color entry is ""; [one word color descriptor]
	now Nipple Shape entry is ""; [shape example: any shape will do as long as it has a baseline with a current infection or item]
	now Back Change entry is ""; [partial sentence that fits in: "Your back [one of]tingles[or]goes flush[or]vibrates with odd pleasure[or]goes cold[or]feels oily[at random] as [Back Change entry]."]
	now Back Adornments entry is ""; [partial sentence to fit: "Your back tickles with the feeling of movement caused by [back adornments of Player]."]
	now Back Skin Adjective entry is ""; [one word adjective (feathered/furred/scaly/...); EMPTY "" for creatures with just skin]
	now Back Color entry is ""; [single word color adjective for the dominant color of the skin/fur/feathers/scales]
	[Limbs Adjective is generated by a function and can be used in scenes too - "rail-thin, slender, sinewy, average, firm, muscular, flabby, meaty, rippling"]
	now Arms Change entry is ""; [partial sentence that fits in: "Your arms [one of]tingle[or]go flush[or]vibrate with odd pleasure[or]go cold[or]feel oily[at random] as [Arms Change entry]."]
	now Arms Description entry is ""; [partial sentence to fit: "Your [Limbs Adjective of Player] arms are [Arms Description of Player]."]
	now Arms Skin Adjective entry is ""; [one word adjective (feathered/furred/scaly/...); EMPTY "" for creatures with just skin]
	now Arms Color entry is ""; [single word color adjective for the dominant color of the skin/fur/feathers/scales]
	now Locomotion entry is ""; [one word adjective: (bipedal/quadrupedal/octapedal/serpentine/sliding)]
	now Legs Change entry is ""; [partial sentence that fits in: "Your legs [one of]tingle[or]go flush[or]vibrate with odd pleasure[or]go cold[or]feel oily[at random] as [Legs Change entry]."]
	now Legs Description entry is ""; [partial sentence to fit: "As your inspection goes even lower, you come to the two [Body Adjective of Player] legs supporting you. They are [Legs Description of Player]."]
	now Legs Skin Adjective entry is ""; [one word adjective (feathered/furred/scaly/...); EMPTY "" for creatures with just skin]
	now Legs Color entry is ""; [single word color adjective for the dominant color of the skin/fur/feathers/scales]
	now Ass Change entry is ""; [partial sentence that fits in: "Your ass [one of]tingles[or]goes flush[or]vibrates with odd pleasure[or]goes cold[or]feels oily[at random] as [Ass Change entry]."]
	now Ass Description entry is ""; [partial sentence to fit: "Using your hands you feel your behind enjoying the sensation of your [Ass Width Adjective of Player], [Ass Shape Adjective of Player] [Ass Description of Player]." (For players with skin, instead of the period: ", covered in [Ass Color of Player] skin and [Body Hair Description of Player]"]
	now Ass Skin Adjective entry is ""; [one word adjective (feathered/furred/scaly/...); EMPTY "" for creatures with just skin]
	now Ass Color entry is ""; [single word color adjective for the dominant color of the skin/fur/feathers/scales]
	now Ass Width entry is 3; [ass width from 1-5]
	[Ass Width Adjective generated by function out of ass width: dainty/small/round/huge/enormous]
	[Ass Adjective generated by function out of body definition and ass width]
	now Tail Change entry is ""; [partial sentence that fits in: "Your rear [one of]tingles[or]goes flush[or]vibrates with odd pleasure[or]goes cold[or]feels oily[at random] as [if HasTail of Player is true]your existing tail is changed into a [Tail Description entry][else][Tail Change entry][end if]."]
	now Tail Description entry is ""; [partial sentence to fit: "Just below your lower back sprouts a [Tail Description of Player], which you move back and forth with glee."]
	now Tail Skin Adjective entry is ""; [one word adjective (feathered/furred/scaly/...); EMPTY "" for creatures with just skin]
	now Tail Color entry is ""; [single word color adjective for the dominant color of the skin/fur/feathers/scales]
	now Asshole Depth entry is 7; [inches deep for anal fucking]
	[Asshole Depth Adjective is generated by a function and can be used in scenes too - "petite (< 3), shallow (< 5), average (< 9), deep (< 15), bottomless (15+)"]
	now Asshole Tightness entry is 3; [asshole tightness 1-5, "extremely tight, tight, receptive, open, gaping"]
	[Asshole Tightness Adjective is generated by a function and can be used in scenes too - "extremely tight, tight, receptive, open, gaping"]
	now Asshole Color entry is ""; [one word color descriptor]
	now Cock Change entry is ""; [partial sentence that fits in: "Your cock [one of]tingles[or]goes flush[or]vibrates with odd pleasure[or]goes cold[or]feels oily[at random] as [Cock Change entry]."]
	now Cock Description entry is ""; [partial sentence to fit: "You have a [Cock Girth Adjective of Player], [Cock Length of Player]-inch-long [Cock Adjective of Player] [one of]cock[or]penis[or]shaft[or]maleness[at random] that [cock Description of Player]."]
	now Cock Adjective entry is ""; [one word adjective: avian/canine/...]
	now Cock Color entry is ""; [one word color descriptor]
	now Cock Count entry is 0;
	now Cock Girth entry is 0; [thickness 1-5, generates the Cock Girth Adjective]
	[Cock Girth Adjective is generated by a function and can be used in scenes too: thin/slender/average/thick/monstrous]
	now Cock Length entry is 0; [length in inches]
	now Ball Count entry is 0; [allowed numbers: 1 (uniball), 2 or 4]
	now Ball Size entry is 0; [size of balls 1-7: "acorn-sized", "dove egg-sized", "chicken egg-sized" "goose-egg sized", "ostrich-egg sized", "basketball-sized", "beachball-sized"]
	[Ball Size Adjective is generated by a function and can be used in scenes too]
	now Ball Description entry is ""; [partial sentence to fit: "Underneath it hangs a pair of [Ball Size Adjective of Player] [Ball Description of Player]."]
	now Cunt Change entry is ""; [partial sentence that fits in: "Your pussy [one of]tingles[or]goes flush[or]vibrates with odd pleasure[or]goes cold[or]feels oily[at random] as [Cunt change entry]."]
	now Cunt Description entry is ""; [partial sentence to fit: "You have a [Cunt Tightness Adjective of Player] [one of]cunt[or]pussy[or]vagina[or]cleft[at random] that [Cunt Description of Player]."]
	now Cunt Adjective entry is ""; [one word adjective: avian/canine/...]
	now Cunt Color entry is ""; [one word color descriptor]
	now Cunt Count entry is 0;
	now Cunt Depth entry is 0;
	now Cunt Tightness entry is 0; [size 1-5, generates adjectives of extremely tight/tight/receptive/open/gaping]
	[Cunt Tightness Adjective is generated by a function and can be used in scenes too: extremely tight/tight/well-used/open/gaping]
	now Clit Size entry is 0; [size 1-5, see Clit Size Adjective]
	[Clit Size Adjective is generated by a function and can be used in scenes: very small/small/average/large/very large]
]

Section 3 - Fuckborg CD Item

Table of Game Objects (continued)
name	desc	weight	object
"Fuckborg CD"	"A shiny CD left behind by one of the Fuckborgs. Light reflects off of it weirdly, giving it an oily appearance."	1	Fuckborg CD

Fuckborg CD is a grab object. Understand "CD" as Fuckborg CD. Fuckborg CD is infectious. Strain of Fuckborg CD is "Fuckbot".

Usedesc of Fuckborg CD is "[FuckborgCDUsing]";

to say FuckborgCDUsing:
	say "You rub the CD carefully, and your eyes start to twitch as you are presented with visions of fucking various creatures in the city. Even without a DVD player, the disk is able to transmit signals right to your brain.";

instead of sniffing Fuckborg CD:
	say "The CD spells mostly like metal and faintly like a fruity, synthetic lube.";


Fuckbot ends here.